XXXXXXXXXXXX
XX.....XX..X
XX...#...#.X
XXXX.XX.##.X
X...#.X....X
X.###.X.XXXX
X...X.X.#.XX
X..X..X..#.X
X.#X.#X....X
X...00X.XXXX
XXXX00.#.X@X
X00000X.#X.X
XX0000X..#.X
XXX00XX....X
XXXXXXXXXXXX