..........XXXXXXX
..........X..000X
......XXXXX..000X
......X......000X
......X..XX..000X
......XX.XX..000X
.....XXX.XXXXXXXX
.....X.###.XX
.XXXXX..#.#.XXXXX
XX...X#.#...X...X
X@.#..#....#..#.X
XXXXXX.##.#.XXXXX
.....X.#....X
.....XXXX.XXX
........X..X
........X..X
........X..X
........XXXX