XXXXXXXXXXXXXXXX
X..............X
X.X.XXXXXX.....X
X.X..#.#.#.#X..X
X.X...#@#...XX.XX
X.X.X#.#.#XXX000X
X.X...#.#..XX000X
X.XXX###.#.XX000X
X.....X.XX.XX000X
XXXXX...XX.XX000X
....XXXXX.....XXX
........X.....X
........XXXXXXX