XXXXX.XXXX
X000X.X..XXXX
X000XXX..#..X
X0000XX.#..#XXX
XX0000XX...#..X
XXX000.XX.#.#.X
X.XX....X..#..X
X..XX.X.XXX.XXXX
X.#.X.X#..#....X
X..#.@.#....#..X
X...X.#.##.#.XXX
X..XXXXXX..XXX
X.XX....XXXX
XXX