.XXXXX
.X...X
.X.X.XXXXXX
.X......#@XXXXXX
.X.#.XX#.XXX...X
.X.XXXX.#....#.X
.X.XXXXX.X..X#.XXXX
XX..XXXX.XX#......X
X..#X..#..X.XX.XX.X
X.........X.X000X.X
XXXXXX..XXX..000..X
.....XXXX.X.X000X.X
..........X.XXX.X.X
..........X.......X
..........XXXXXXXXX