.XXXX
XX..XXXXX
X.......X.XXXXX
X.#XXX..XXX...X
X00X..#X.X..X.X
X00X......##X.XXX
X0&X.X..X#.#....XXXXX
X00X..XX.....XX#X...X
X0&#..#.X.XX..#.....X
X00XX..#...X...XXXXXX
X0&XX#XX...XXXXX
X00..#.XXXXX
X..X.@.X
XXXXXXXX