.XXXXXXX
.X..X..XXXXX
XX..X..X000XXX
X..#X..X000..X
X.#.X##.000..X
X..#X..X000.0X
X...X.#XXXXXXXX
XX#.......#.#.X
XX..X..##.X...X
.XXXXXX..XX##@X
......X......XX
......XXXXXXXX