XXXXXXXXXXXX..XXXXXX
X...X....X@XXXX0000X
X...##X.......00000X
X...X.XXX...XX.0000X
XX.XX.XXX..X...0000X
.X.#.#.....X.XX.XXXX
.X..#.#XX..X.......X
XXXX.X..XXXX.XX.XX.X
X..X.X#...XX.XX....X
X.#..#..X.XX.XXXXXXX
X.X.#.#....X.X
X..#.XX.XX.X.X
X.##.....##..X
XX.XX.XXX.#..X
.X....X.X....X
.XXXXXX.XXXXXX