..............XXXXXXXX
..............X..0000X
...XXXXXXXXXXXX..0000X
...X....X..#.#...0000X
...X.###X#..#.X..0000X
...X..#.....#.X..0000X
...X.##.X#.#.#XXXXXXXX
XXXX..#.X.....X
X...X.XXXXXXXXX
X....#..XX
X.##X##.@X
X...X...XX
XXXXXXXXX