..............XXX
.............XX0XXX
.............X0000X
.XXXXXXXXXXXXX0000X
XX...XX.....XX0000XXXXX
X..##XX..#.@XX0000....X
X......##.#X..0000X...X
X..#.XX.##.X.X0000X..XX
X..#.XX.#..X.XX.XXX..X
XX.XXXXX.XXX.........X
XX...#..#.XXXXX.XXX..X
X.#XXX..X.XXXXX.X.XXXX
X...#...X.......X
X..#.X#.#.#XXX..X
X.###X.#...X.XXXX
X....X..##.X
XXXXXX...XXX
.....XXXXX