...............XXXX
..........XXXXXX..XXXXX
....XXXXXXX.......X...X
....X......#.#.XX.X.X.X
....X..XXXX.#..X.....0X
....X......#.X.X.XX0X0X
....XX#XXXX#.#.#.XX0X0X
....X.....X....XXXX0XXX
....X.#...XXXXXX..X0X0X
XXXXXX###XX......@X0X0X
X......X....X#X#XXX0.0X
X.XXXX.X#####....X.000X
X.X....#.....X...X.000X
X.X...XX.XX.....XXX000X
X.XXXXXX#XXXXXX..XXXXXX
X........X....X..X
XXXXXXXXXX....XXXX