..XXXX
..X..XXXXXXXXXXX
..X....#...#.#.X
..X.#X.#.X..#..X
..X..#.#..X....X
XXX.#X.X..XXXX.X
X@X#.#.#..XX...X
X....#.X#X...X.X
XX..#....#.#.#.X
.XXXX..XXXXXXXXX
..XXX..XXX
..X......X
..X......X
..X000000X
..X000000X
..X000000X
..XXXXXXXX