.XXXXX
.X...XXXXXXX
.X.#.XXX...X
.X.#....##.X
.XX.XXXX...X
XXX.X..X.XXX
X...X..X@XX
X.##....#.X
X...X.X.#.XXXX
XXXXX.X...X..X
.X...#XXXX...X
.X..#.....#..X
.XX...XXXXX.XX
.XXXXXXXXXX..X
XX0000X.#..#.X
X00000X.##X..X
X00.00X.#..#.X
X00000#...X..X
XX..XXXXXXXXXX
.XXXX