XXXXXXXXXXXX
X00..X.....XXX
X00..X.#..#..X
X00..X#XXXX..X
X00....@.XX..X
X00..X.X..#.XX
XXXXXX.XX#.#.X
..X.#..#.#.#.X
..X....X.....X
..XXXXXXXXXXXX