................XXXXX
.......XXXXXX.XXX...XXXX
...XXXXX....XXX.#.#..#.X
XXXX..XX.X#.#....#.X...X
X0000...##.#.#..#...X#XX
X00.X.XX.X...XXX#XX.X..X
X0000....X.XXX....X....X
X0000....X.XX..#..XXX#.X
X00XXXXXX..#..X..XXXX.XX
XXXX....X...XXX....@..X
........XXXXXXXXXXXXXXX