XXXXXX..XXX
X00..X.XX@XX
X00..XXX...X
X00.....##.X
X00..X.X.#.X
X00XXX.X.#.X
XXXX.#.X#..X
...X..#X.#.X
...X.#..#..X
...X..XX...X
...XXXXXXXXX