.......XXXXX
.XXXXXXX...XX
XX.X.@XX.##.X
X....#......X
X..#..XXX...X
XXX.XXXXX#XXX
X.#..XXX.00X
X.#.#.#.000X
X....XXX000X
X.##.X.X000X
X..XXX.XXXXX
XXXX