.....XXXX
...XXX..XX
XXXX..#..X
X...#.#..XXXX
X.#...X.#...X.XXXX
X..X..X...#.X.X00X
XX#X#.XXXX#XXXX00X
.X...XXXXX.XX.000X
.X#X.XX@XX.XX..00X
.X.X....#.....000X
.X...XXXX.XXX..00X
.XXX.XX.X..XX.000X
..XX#.XXXX#.XXX00X
..X...XX....X.X00X
.XX.##XX..#.X.XXXX
.X.....####.X
.X.#.XXX....X
.X...X.XXXXXX
.XXXXX