....XXXXXXXXX
..XXX...XX..XXXXX
XXX......X..X...XXXX
X..##.X#.X..X..000.X
X.X..#X@#XX.X.X0X0.X
X..XX.X#..X....000.X
X.#X....#.X.X.X0X0.X
X....XX..XX#.#.000.X
X.#.XX...X..X#X0X0.X
XX.##..#...#..#000.X
.X#..XXXXXX....XX..X
.X...X....XXXXXXXXXX
.XXXXX