.........XXXX
.XXXXXXXXX..XX
XX..#......#.XXXXX
X...XX.XX...XX000X
X.X##.#.##X#XX000X
X.X....@..X...000X
X..#X.XXX##...000X
X.#..##..#.XX0000X
XXX#.......XXXXXXX
..X..XXXXXXX
..XXXX