...XXXXXXXXXX
...X..XXX...X
...X.#...#..X
...X..XXXX#XX
...XX.X..X..X
..XX..X0&...X
..X..XX00X..X
..X.@.X0&X.XX
..X.X#X00X#.X
..X.#.X00X..X
..X.X.X&&X..X
..X.#.X00X#XX
..X....0&X..X
.XXX..X..X..X
XX....XXXX..X
X..XXXXXXX#XX
X.#......#..X
X..XX...X...X
XXXXXXXXXXXXX