........XXXXXXX
....XXXXX..X..XXXX
....X...X...#....X
.XXXX.X##.XX.XX..X
XX......X.X..XX.XXX
X..XXX.#X#..#..#..X
X000....X.XX..X...X
X000X....@.X.XXX.XX
X000X..XXX..#..#..X
XXXXXXXX.XX...X...X
..........XXXXXXXXX