.......XXXXXXX
.......X..X..XXXX
.......X.#X#.X..XX
XXXXXXXX..X..X...XXXXXXXX
X0000..X.#X#.X..#X..X...X
X0000X.X.....X#..X......X
X00X0....#X..X.#....X#..X
X000.@XX..X#.X#..X..X...X
X0000.XX.#X.....#XXXXXXXX
XXXXXXXX..X##X#..X
.......X.#X..X..#X
.......X..X..X...X
.......XXXX..XXXXX
..........XXXX