............XXXX
.XXXXXXXXXXXX..XXXXX
.X....X..X..#..X...XX
.X.#.#.#..#.X.#.#...X
.XX#.#...X.@X.#...#.X
XXX...XXXXXXXXXXXX.XX
X..#.#X..X000000X.#X
X.X...X..X000000XX.X
X..XX.XX.X.00000X..X
X.X......#000000.#.X
X.X.#.XX.X000000X..X
X..#.#X..X000000X.#X
X.#...X..XX#XXXXX..X
X.#.#.XXXX.#.#..#.#X
XX.X.....#.#.#.#...XXX
.X..XXXXXX.#....#....X
.X.........X.XXXXXXX.X
.XXXXXXX.X#..........X
.......X...XXXXXXXXXXX
.......XXXXX