........XXXXX
........X...XXXX
........X.#....XXXX..XXXX
........X...X.#X..XXXX..X
XXXXXXXXXXX.X...#...X...X
X00.....X.#..XXXX.X..X..X
X00#..X...#..X..#.X.#.0XX
X0&X.X.#.#.XX..XX....X0X
X00X#.@.X...XX....##.X0X
X00X.#.#..#.#.XX...XX.0X
X0&##.X.XX...#.X#X.#.X0X
X00X......XX...X.....X0X
X00XXXXXXX..XXX.XXXXXX0XX
X.##..................&0XX
X..XXXXXXXXXXXXXXXXXX..00X
XXXX................XXXXXX