....XXXXX
....X...X
....X#..X
..XXX..#XXX
..X..#..#.X
XXX.X.XXX.X.....XXXXXX
X...X.XXX.XXXXXXX..00X
X.#..#.............00X
XXXXX.XXXX.X@XXXX..00X
....X......XXX..XXXXXX
....XXXXXXXX