XXXXXXXXX
X.......X
X.......XXXX
XX.XXXX.X..X
XX.X@XX....X
X.###.#..##X
X..X.XX.#..X
X..X.XX..#.XXXX
XXXX..###.#X..X
.X...XX...0000X
.X.X...X.X00.0X
.X...X.X.XX000X
.XXXXX.#..X000X
.....XX...XXXXX
......XXXXX