.XXXXXXXXXXXXXXXXXXXXX
.X...XX..X...X...X...X
.X.#.....#...#...#...XX
XXXXX.X..X...XXX.XX#XXX
X...X.XX#XXXXXX...X...X
X.#...X.000000X...X.#.X
XX.X..X.000000XXXXX...X
XX.XXXXXXXXX00X...X.XXX
X..........X00X.#...X
X.XX.XXX.XXX00XX.X..XXX
X.X...X...XX00XX.XXX..X
X...@......#00X.......X
X.X...X...XX..X...XX..X
XXXXX.XXXXXXXXXXXXXX.XX
X..........X...X....#.X
X.#..X.#.#.#...X.X....X
X.X#XX.#X..XX.XX....X.X
X..#.##.XXXX.#..#.X.X.X
X..........X...X......X
XXXXXXXXXXXXXXXXXXXXXXX
